WE ./path_to_the_west_texture
EA ./path_to_the_east_texture
SO ./path_to_the_south_texture
NO ./path_to_the_north_texture

F 220,100,0
C 25,101,0

11111111111111111111111111111
10000000001100000000000011111
10110000011100000000000011111
10010000000000000000000011111
11111111101100000111000000001
10000000001100000111011111011
11110111111111011100000010001
11110111111111011101010010001
11000000110101011100000010001
10000000000000001100000010001
10000000000000001101010010001
1100000111010101111100011N001
11110111111101011101111010001
11111111111111111111111111111